11111111111
1P000000101
1C0000001E1
11111111111