111111111111111111111
1C0001C1CC000000000C1
1110011100000001C0011
1P0000000E00000CCCC01
111111111111111111111