1111111111111111
1EC000000000C001
1P10001000000001
1111111111111111