1111111
1EC0001
1P10001
1111111