11111111111111111111111111111111111111111111111111
1C0000CCCC0000C00000111111100000000CCC0000000000C1
1000100001C001100001000000000001000000000111000011
100100000100011C0001000001110001001000001111100001
1P001E100000000CC0C0000111CCCC11CCCCC1100000000001
1C0000CCCC010000000000111111000000000C0110C0000C11
100010101C001100001000000000001C000000110111000111
1C0000C1CC010100000C0110C111000000CC10000C00000011
1000101000010011C00000000000001000001100011100C001
1C00C00CCC0000C1000001111111000000C0C0000C00000011
1000101000110110000100001C0000010C0001110111001C11
11111111111111111111111111111111111111111111111111