111111111111111111111111111111111111111111111111111
1E0000000000000000000000000000000000000000000000001
100010000000000000000000000000000000000000000000001
100010000000000000000000000000000000000000000000001
100010000000000000000000000000000000000000000000001
100010000000000000000000000000000000000000000000001
100010000000000000000000000000000000000000000000001
100010000000000000000000000000000000000000000000001
100010000000000000000000000000000000000000000000001
100010000000000000000000000000000000000000000000001
100010000000000000000000000000000000000000000000001
100010000000000000000000000000000000000000000000001
100010000000000000000000000000000000000000000000001
100010000000000000000000000000000000000000000000001
100010000000000000000000000000000000000000000000001
100010000000000000000000000000000000000000000000001
100010000000000000000000000000000000000000000000001
100010000000000000000000000000000000000000000000001
100010000000000000000000000000000000000000000000001
100010000000000000000000000000000000000000000000001
100010000000000000000000000000000000000000000000001
100010000000000000000000000000000000000000000000001
100010000000000000000000000000000000000000000000001
100010000000000000000000000000000000000000000000001
10001000000000000000000000000000000000000000000CP01
111111111111111111111111111111111111111111111111111