111111111
100000001
1C00000C1
1P0000C11
111111111